NO ./assets/textures/N.xpm 1  
SO ./assets/textures/S.xpm 1  
WE ./assets/textures/W.xpm 1 
EA ./assets/textures/E.xpm 1  


F 50,100,10							 
C 100,100,255							 

1111
1N11
1