NO ./assets/textures/N.xpm 1
SO ./assets/textures/S.xpm 1
WE ./assets/textures/W.xpm 1
EA ./assets/textures/bad_texture.xpma 2

F 0,100,50
C 0, 100,250

11111111111111111111111111111111
10000000000000000000000000000001
10000000000000000000000000000001
10000000000000000000000000000001
10000000000000010000000000000001
10001000000000000000000000000001
100000000011000000000000E0000001
10000000010010000000000000000001
11111111111111111111111111111111
