NO ./assets/textures/N.xpm 1
SO ./assets/textures/S.xpm 1
WE ./assets/textures/W.xpm 1
EA ./assets/textures/E.xpm 1

F 50,100,10
C 100,100,255

11111111111111111111111111111111
10000000000000000000000000000001
10000000000000000000000000000001
10000000000000000000000000111111
10000000000000010000000001
10001000000000001000000000111111
100000000011000000000000E0000001
11010101010111010101010101010101
1 1 1 1 1 1 1 1 1 1 1 1 1 1 1 11










