NO ./assets/textures/N.xpm	16
SO ./assets/textures/S.xpm	16
WE ./assets/textures/W.xpm	16
EA ./assets/textures/E.xpm	16

F 50,100,10
C 100,100,255

11111111111111111111111111111111
10000000000000000000000000000001
10000000100000000000010000000001
10000000000000000000000000000001
10000000000000001000000000a00001
10001000000000000000000000000001
100000000000010000000000N0000001
10000000000000000000000000000001
11111111111111111111111111111111
