NO ./assets/textures/north_texture.xmp	# Texture of north-facing walls
SO ./assets/textures/south_texture.xmp	# Texture of south-facing walls
WE ./assets/textures/west_texture.xmp	# Texture of west-facing walls
EA ./assets/textures/east_texture.xmp	# Texture of east-facing walls

F 50,100,10								# Floor color
C 100,100,100							# Ceilling color

# Closed Map (Without #)

11111111111111111111111111111111
1N000000000000000000000000000001
10000000000000000000000000000001
10000000000000000000000000000001
10000000000000000000000000000001
10000000000000000000000000000001
10000000000000000000000000000001
10000000000000000000000000000001
11111111111111111111111111111111
