NO ./assets/textures/N.xpm 1 # Texture of north-facing walls
SO ./assets/textures/S.xpm 1 # Texture of south-facing walls
WE ./assets/textures/W.xpm 1 # Texture of west-facing walls
EA ./assets/textures/E.xpm 1 # Texture of east-facing walls

F 50,100,10								# Floor color
C 100,100,255							# Ceilling color

# Closed Map (Without #)

11111111111111111111111111111111
10000000000000000000000000000001
10000000000000000000000000000001
10000000000000000000000000000001
10000000000000010000000000000001
10001000000000000000000000000001
100000000011000000000000E0000001111111111111111111111111111111111
100000000100100000000000000000000000000000000000000N0000000000001
11111111111111111111111111111111111111111111111111111111111111111
