NO ./assets/textures/N.xpm 1 # Texture of north-facing walls
SO ./assets/textures/S.xpm 1 # Texture of south-facing walls
WE ./assets/textures/W.xpm 1 # Texture of west-facing walls
EA ./assets/textures/E.xpm 1 # Texture of east-facing walls

F 50,100,10								# Floor color
C 100,100,255							# Ceilling color

# Closed Map (Without #)

1111111111111111111111111111111111111111111
1000000000000000000000N00000000000000000001
1111111111111111111111111111111111111111111
